1111111
1400041
1032301
1011101
1030301
1400041
1111111