1111111
1200001
1003001
1000001
1000401
1111111







