1111111
1000001
1000001
1000041
1101111
1000301
1200001
1111111