00000011110
00000010010
11111110411
10011000041
12000033001
11110000011
00011111100